EA textures/ea.xpm
NO textures/no.xpm
SO textures/so.xpm
WE textures/we.xpm
F 255,100,0
C 50,130,130

1111111111111111111        111111111111111111
1000000000000000001        100000000000000001
1000000000000000001        100000000000000001
100000000000000000111111111100000000000000001
100000000N00000000000000000000000000000000001
100000000000010000000000000000000000000000001
100000000001111100000000000000000000000000001
100000000111111111000000000000000000000000001
100000000001111100000000000000000000000000001
100000000000010000000000000000000000000000001
100000000000000000000000000000000000000000001
100000000000000000000000000000000000000000001
100000000000000000000000000000000000000000001
100000000000000000000000000000000000000000001
100000000000000011111100000000000000000000001
100000000000011100000000000000000000000000001
100000000001100000000000000000000000000000001
100000000010000000000000000000000000000000001
100000000100000000000111111111111110000000001
100000001000000000000000000000000000000000001
100000001000000000000000000000000000000000001
100000001000000000000000000000000000000000001
100000001000000000000000000000000000000000001
100000001000000000000000000000000000000000001
100000001000000000000000000000000000000000001
100000000000000000111111111111000000000000001
1000000000000000001          1000000111100001
1000000000000000001          1000000111100001
1000000000000000001          1000000111100001
1000000000000000001          1000000000000001
1111111111111111111          1111111111111111
