EA textures/ea.xpm
NO textures/no.xpm
SO textures/so.xpm
WE textures/we.xpm
F 13,13,15
C 3,3,0

1111111111111
1000000000001
1111111111101
1000000000001
1111111111101
1000000000001
1011111111111
1000000000001
1111110111111
1111000000001
1111000011111
1111110011111
     1001  
     1001 
1111110111111
1000000000001
100000000000111111111111
10000000000000000000000001
10000000000011111111111111
1000000000001
1000000000001
1000000000001
1000000000001
1000000000001
10000W0000001
1111111111111