EA textures/ea.xpm
NO textures/no.xpm
SO textures/so.xpm
WE textures/we.xpm
F 255,100,0
C 225,30,0


11111111111111111111111111111
10000000000000000000000000001
10001000000000000000100000001
10000000000000000000000000001
10000000N00000000100000000001
10000000000000000000000000001
10000000000000000000010000001
10001111111111111110000000001
11111111111111111111111111111
