EA textures/ea.xpm
NO textures/no.xpm
SO textures/so.xpm
WE textures/we.xpm
F 255,100,0
C 225,30,0

1111111111111111111        111111111111111111
1000000000000000001        100000000000000001
1000000000000000001        100000000000000001
100000000000000000111111111100000000000000001
100000000N00000000000000000000000000000000001
100000000000000000000000000000000000000000001
100000000000000000000000000000000000000000001
100000000000000000000000000000000000000000001
100000000000000000111111111111000000000000001
1000000000000000001          1000000111100001
1000000000000000001          1000000111100001
1000000000000000001          1000000111100001
1000000000000000001          1000000000000001
1111111111111111111          1111111111111111
