EA textures/ea.xpm
NO textures/no.xpm
SO textures/so.xpm
WE textures/we.xpm
F 13,13,15
C 3,3,5

1111111111111
1000000000001
1111111111101
1000000000001
1111111111101
1000000000001
1011111111111
1000000000001
1111110111111
1111000000001
1111000011111
1111110111111
     101  
     101 
112113D311211
1000000000001
1000000000001
1000000000002
1000000000001
1000000000001
1000000000001
1000000000002
1000000000001
1000000000001
10000S0000001
1111111111111