EA textures/ea.xpm
NO textures/no.xpm
SO textures/so.xpm
WE textures/we.xpm
F 24,22,32
C 34,32,52


111111111111111111111111111111111111111111111111111111111111111111111111111111111111111111111
100000000000000000000000000000000000000010000000000000000000000000000000000000000000000000001
100000000000000000000000000000000000000010000000000000000000000000000000000000000000000000001
100000000000000000000000000000000000000010000000000000000000000000000000000000000000000000001
100000000000000000000000000000000000000010000000000000000000000000000000000000000000000000001
100000000000000000000000000000000000000010000000000000000000000000000000000000000000000000001
100000000000000000000000000000000000000010000000000000000000000000000000000000000000000000001
100000000000000000000000000000000000000010000000000000000000000000000000000000000000000000001
100000000000000000000000000000000000000010000000000000000000000000000000000000000000000000001
100000000000000000000000000000000000000010000000000000000000000000000000000000000000000000001
1000000000000000000000000000000000000000S0000000000000000000000000000000000000000000000000001
100000000000000000000000000000000000000010000000000000000000000000000000000000000000000000001
111111111111111111111111111111111111111111111111111111111111111111111111111111111111111111111
